0000000000000120000000000000000000000001200000000000001111111110000001111111000011111111100000011111110000000000000001100000000000000000000000011000000000000011111111100110011111110000111111111001100111111100000000000000000000000000000000000000000000000000000000111111100110011111100000001111111001100111111006660000002200000000110000067000000022000000001100000600001111111001100111111006660011111110011001111110000000000000000000000000000000000000000000000000000000000011111111100110011111110000111111111001100111111100000000000000011000000000000000000000000110000000000000111111111000000111111100001111111110000001111111000000000000000120000000000000000000000001200000000000
0000000033330000220000000000000000333300002200000000001111000033110011111111110011110000331100111111111100000000000011000000000000000000000000110000000000002222001111001122221111001122220011110011222211110011000000000000333300000000000000000000003333000000000000000000001133111111110000000000000011331111111106660000110022003300001111067000001100220033000011110600221111000000221111111106662211110000002211111111000000000000002200000000000000000000000022000000000000000011112211000011001100111100111122110000110011001111000022003333330000220000110000220033333300002200001100111100110011111111001111001111001100111111110011110000000022000000000000000000000000220000000000000000
0000113333330000110011112200001133333300001100111122003333333333330111000011110033333333333301000000111100333333333300000000000011003333333333000011000000110033333333330001110022220000333333333300011100000000111100001100000011000000001111000011000000000000000000000000110000000011000000000000001100000011110006660000000011112200100000067000000000111122001000000600000000111000220010011006660000001110002200100110000011000000000022001001100000110000000000220010011000000000001111000033333333331100000011110000333333333311000200110000003333333333000002001100000033333333330000020011000033333333333300000200111111333333333333000002001100000033333300000000020000000000333333000000
0033332000550000000000332200333320005500000000003322333300000000000000101100333333000000000000111011003333000000000011111110111000330000001111111111101110000000001110000011111101100000001111100000111111011000000111110022011111111000000001111100000111111110000000111111000001111111110000001111110000011111111106660011111100220011111111067000111111000000111111110600000111111000001111111006660001111110000011111110000000011111111111111111011000000111111111111111110110000000111111111111111011100000001111110000111110111000000001110000000011101100330000011100000000001011003333000011110055000000003333330000000000550000000033330033200000005500000033332200332000000055000000333322
0002221110001100550000111000022211100011005500001110000000000000110055000011000000000000001100550000110000011111000100005500001000000111110001000055000010000000001100000000000100000000000011000000000001000000111100111055555555011100001111001110555555550111000011000000005511000000100000110000000055110000001006660000111100000000220010067000001111000000002200100600000000110055110000001006660000001100551100000010000000200000005511001100110000002000000055000011001100000020005555550000000001100000200055555500000000011000002200550000000000000011000022005500000022222200110000000000001100220011000000000000000011000000110000000000005500110000001100000000000055001100000011000000
0000000000110022200000000000000000001100222000000000001111110011001120111100000000001100110011201111000000000000001100112000111001002222000000001120000010010000000000000000000000000000000000110000000000000000001111112000001001110000000000001120001110011100000000000000003333330000100000110000000033333300001006660000112211113333330000067000001122111133333300000600110000000033333300001006660000000000333333000010000033000011100011100111000000331111111000001001110000003333333322000000000000000033333333000000110000000000001111000000001120000033010000000000110011200011330100000011331100112000113333001111113311001120001133330033333333110022200033333300333333331100222000333333
0000000000000022000000000200000000000000000000000002000000220022000000222000020000002200222200222220000200222200000000002200200000002222000000000022002000000020000000332200000022000000200000003322000000220000002000003322222200000000000020000033222222000000000000200033222200000000000000002000332222000000000006660000332222220022222233067000003322222200222222330600200000000000002222330006662000000000000022223300000020002000002222223300000000200020000022222233000000000000220000002200000022200000002200000022000000222000002222222000000000220000000022222220000000002200000000000000220000002222000200000000002200002222220002000000000000000000000000220000000000000000000000002200
0033333300001100553333330000333333000011005533333300001133551100110055333302000011335511001100553333020011113355001100000000111100111133550011000000001111000011005500001122550000000000110055000011225511000000000000550000000055001111000000005500000000550000000011111055000000025500000000111110550011110255000006660000005501111100550100067000000055011111005501000600010211550111113355010006660102115501111133550111000000000055001033330000000000000000550010333300000000001111105500111133550002100111111055001111335500021001001100550010023355000100000000005500100233550001000000000000002002005500111110000011000020020055001111100000115500201100550000000000000055002011005500000000
0011000000002200001111000000110000000022000011110000000000000000110000000000000000000000001100000000000000000000000000000000000111000000220000000000000001111100022220330033000033001111000222203322330022330011000033223302222002222000000000330033022220022220000000000000003322330022330000000022000033003300003306660002222000000000000000067000022220000000000000000600003322330033003300003306660033003300332233002233000000000000000222200222200000002200000002222002222000000222200000332233002233001102222000003300330000330011332233000000000000000001113300330000000000000000011100000000000011000000000000000000000000110000000000000011000000002200001111000000110000000022000011110000
0000001111000000001111000000001111111100000011110000000010000001110000333300000011100000011100003333000000100000000111111110333300001000000001111111103333000011000000111111111033331100110000111111111110333300000011111155222211103333000000111111552222111033330000000033335522001122330000000000333355220011223306660000333322551111112233067000003333225511111122330600000033332255220011103306660000333322552200111033000000000033335522221110333300000000333355222211103333000000111111551111111033330000001111115511111110333300001100001111111111103333110011000000111111111033330000100000001111111133333300001000000011110000333333000011000011111100001111000000001111111100000011110000
0000000000000000220000000000000000000011002211000000000000000010110011111100010011001111101100111111000100110000001011000033333333001100000010110000333333330011110011101122333333333300110000111011223333333333001100001122000033330000000011000011220000333300000022111100110022003333000000221111001100220033330006660000000022003333333300067000000000220033333333000600111111221111333322000006661111112211113333220000000000001100110033333300200000000011001100333333002000001100003333333333330011110011000033333333333300111100110033333333333333001100001100333333333333330011000000003333100000111111110000000033331000001111111111000000333322000000001100000000003333221100000000000000
0000000000110055001100110000000000001100550011001100001100550000005500110000000011005500000055001100000000110055021100550011110000001100550211005500111100000011005502110000000000000000110055021100000000000000000111550211225500002000000001115502112255000020000000000055555555551100200000000000555555555511002006660001100000550011200000067000011000005500112000000600110000111155001120000006661100001111550011200000000011000011000000000000000000110000000000000000000000001111000022555555550011110011110000225555555500111100000000002211200055001100000000000000112000550011000000001111111100005500000000000011111111000055000000000000112000000000000000110000001120000000000000111100
0000000000001111111111111100000000000011111111111111001111221110022211221111110011112211100222112211111100110000000000000000110000001100000000000000001100000011001111000011110011000000110011000000001100110000011100103333333301001110000111001033333333010011100000000000023333200000000000000000000233332000000006660000110022333322001100067000001100223333220011000600000000000233332000000006660000000002333320000000000001110010333333330100111000011100103333333301001110000011001100000000110011000000110011110000111100110000001100000000000000001100000011000000000000000011000000112211222001112211221100001122112220011122112211000000001111111100000022000000000011111111000000220000
0033330000333355000000112200333300003333550000220000003300000000335500000011220033000000003355000022000000000000000000550000001122000000000000005500002200000000001111110000000000000000001111111100000000000022000111113311111100110000000001111133111111110000000000111133331133110011000000001111333311331111000006660011111111111111001100067000111111111111111100000600001111333311331100110006660011113333113311110000000000011111331111110011000000000111113311111111000000000000111111110000000000002200000011111100000000000000000000000000005500002200000000000000000055000000112200330000000033550000220000003300000000335500000011220033330000333355000022000000333300003333550000001122
0000333333000000000000000000003333330000220000000000003333203333112011111100000033332033331120111111000000333311113311110000111110003333111133111100001111100011333333111111110011000000113333331111111100000000111133113302110000000033001111331133021100001111330011003311333311000211100000110033113333110002111006660000331120333300011033067000003311203333000110330600000033333333331110333306660000333333333311103333000011111133333311103333011100111111333333111033330111000000113311111100331133333300001133111111003311333333000000332200110011001110330000003300000000110011103300000011111133001100333333000000111111330000003333330000002200003333333333000000000022000033333333330000
0000000000000000001111222200000000000000000011112222000000333333330000001111220000003333333300000011112200220000330000330000001111002200003300003300000011110033330000330000330000001100333300003300003300000011002200000000330000000000000022000000003300000000000000003300333300000000000000000033003333000000000006660000023300000000333300067000000233000000003333000600000000013300003300003306660000000133000033000033000000000000023333333300003333000000000233333333000033330000000000013333333333000000000000000133333333330000000000000000023333333333000000000000000233333333330000000000000000013333333333000000000000000133333333330000000000000000002233333300000000000000000022333333
0000004444001100004444111100000044440011000044441111001111444400110011444444110011114444001100114444441100000044440011001144444422000000444422110011444444000011002244441111111144440000110000444411111111444400011111114444441100444444000111111144444411004444440000000000444444444400200000000000004444444444002006660000220011444444440000067000002200114444444400000600004444111111444444002006660044441111114444440020000000444444000044441100000000004444441111444411000000000044444411114422111100111100444444000044001111001111011144440000440000000100000111444400004400000001000000114444002011001111110011001144440020110011111100110000000000201100000000000000000000002011000000000000
0000110000000000222222330000001100000000002222223300001133110000000022000022000011331100000000220000220000001133110011112211002200000011331100111122110022000000001100001100331122220000000011000011003311222200000000003322223300110000000000000033222233001100000000000000220011111111000000000000002200111111110006660000111111110022000000067000001111111100220000000600000011003322223300000006660000110033222233000000000022221133001100001111000000222211330011000011110000002200111111110000112222000022001111111100001122220000220000220000000000221111002200002200000000002211110033222222000000000000112222332222220000000000001122220000000000000000000000222200000000000000000000002222
0000000111203333330100000000000001112033333301000000111120000000333333001111101111200000003333330011111000000001112000333301000000000000011120003333010000001111200010000033330011111011112000100000333300111110000000111122111133110000000000001111221111331100000011112000000000103333000000111120000000001033330006660000000011203333333333067000000000112033333333330600111120000000001033330006661111200000000010333300000000000011112211113311000000000000111122111133110000001111200010000033330011111011112000100000333300111110000000011120003333010000000000000111200033330100000011112000000033333300111110111120000000333333001111100000000111203333330100000000000001112033333301000000
0000002000110011100000000000000020001100111000000000000000000000001100021111000000000000000011000211110000000011111100000000000000000000111111001111000000005500555555550111000002110055005555555501110000021100000000000055000000000000000000000000550000000000000011000122000000221111100000110001220000002211111006660000220000550033330010067000002200005500333300100600000000011155333333331006660000000111553333333310000011111110005500333300000000111111100055003333000000000000000000555555555500555500000000005555555555005555112211110000000000003333001122111100000000000033330000000000000020011133333333000000000000200111333333330000000000112001000033330000000000001120010000333300
0000003333333333110022000000000033333333331100220000000133330000003333110022000001333300000033331100220000113300222200333311111100001133002222003333111111000111330000003333111122100001113300000033331111221000011133000000003311111122000111330000000033111111220001113300222200333311110000011133002222003333111106660011330000000033331111067000113300000000333311110600001133000000003333111106660011330000000033331111000001113333000033331111111100011133330000333311111111000011113333333311111111110000111133333333111111111100000011113333111111111122000000111133331111111100220000000011333311111100002200000000113333111111000022000000000000001111002222220000000000000000000022222200
0000000000331122113300003300000000003311221133000033000000330000331133000033220000003300003311330000332200003311330000330000000033000033113300003300000000330000003311330000003333000000000033113300000033330000003300003300000033111133000033000033000000331111330033223300000033000033330000332233000000330000333306660033000000332233000000067000330000003322330000000600000000330000330000330006660000003300003300003300000000003311330000003311330000000033113300000033113300000000331133000033003300003300003311330000330033000033000000330000332233000033110000003300003322330000331100000000003300330000332233000000000033003300003322330000000033223300000000330000000000332233000000003300
0000000000332233000000000000000000003322330000000000000000220000330000000000000000002200003300000000000000000022000000000000000022000000220000000000000000220000003322000000002200000000000033220000000022000000000000333322000222000000000000003333220002220000000000220011333333200000000000002200113333332000000006660022222222333333022200067000222222223333330222000600000000113333332000000006660000001133333320000000000000000033332200022200000000000000333322000222000000000000003322000000002200000000000033220000000022000000000000220000000000000000220000002200000000000000002200000044000033000000000000000000220000330000000000000000000000332233000000000000000000003322330000000000
0000003300110000001100000000000033001111110011111100000033330020000000000000000000333300200000000000000022113333330001102211111110221133333300011022111111100000003333011100000000000000000033330111000000000000111111330110444444444400001111113301104444444444000020333333011044444444440000203333330110444444444406660000001120004444444444067000001111200044444444440600001011111100444444444406660010001111004444444444000000110011000044444444444400001100110000444444444444000011000000114444444444444400110000111144444444444444001100001110444444444444441111001111104444444444444400002211100044444444444444000022111000444444444444440000220000004444444444444400002200111144444444444444
0000000000002200000000111100000000000022000000001111001111110000000022110000000011111100000000221100000000000000002222111100001111000000000022221111000011112211110000000011110011110022111100000000111100111100000000001111000000000000000000000011110000000000000011000011110011111111110000110000111100111111111106660000220000000000112211067000002200000000001122110600110000221111220000002206661100002211112200000022000000000011111100001100000000000000111111000011000000001122220000000011110022111111222200000000111100221111000000002211222200000022110000000022112222000000221122002200001111000011000011220022000011110000110000110000222200000000111111000000002222000000001111110000
0002333333333300000000222200023333333333000000002222000002333333200000550000220000023333332000005500002255000000332000005555000000550000003320000055550000005555002000020000330000000055550020000200003300000000003300010000100000000000000033000100001000221100000000000000220022110000000000000000112211220000000006660011220001000010000000067000000000010000100022110600000000000022002211000006660000000011221122000000000000001122000100001000330000000000000001000010003300000000003300002000020055550000000033000020000200555500000055550000003320000055000000555500000033200000550000005500000233333300000000000055000002333333000000000000000002333333333320002200000000023333333333200022
0022000000330000003300000000220000003300000033000000002222221122000000220000000022222211220000002200000000000000002222221122000000000000000022222211220000000000000000003300002211222200000000000033000022112222222222220022220000330000002222222200222200003300000000000022001133332233000000000000220011333322330006660000002222220000001100067000000022222200000011000600002200000011000000220006660022000000110000002200000000222233221111222222330000002222332211112222223300000000000022000000220033332200000000220000002200333322000022222200000011110000000000222222000000111100000000002200000022222222111111000022000000222222221111110000330000002200000000000000003300000022000000000000
0000000000000002330000000000000000000000023300000000000000000000013333333333330000000000000133333333333300000000000233334444444444000000000002333344444444440000000001333344444444444400000000013333444444444444000000023333444444444444000000000233334444444444440000000133334444444444440000000001333344444444444406660002333344444444444444067000023333444444444444440600000001333344444444444406660000013333444444444444000000000002333344444444444400000000023333444444444444000000111111333344444444444400001111113333444444444444002211111111333344444444442222000000003333444444444422000000000001333333333333000000000000013333333333330000000000000002330000000000000000000000023300000000
0000000000333300220000001100000000003333002200000011001100002233331100000000000011000022333311000000000000555500001133555500001100005555000011335555000011000055550000000055550022000000555500000000555500220000000011005555000033333311000000110055550000333333110000223333555500113300000000002233335555001133000006660000333300220000555500067000003333002200005555000600001133333300000055550006660011333333000000555500000000005555000000003333330000000055550000000033333300000000555500002200333333001100005555000022003333330011110000110000000000555500221100001100000000005555002200002200001100001155550000000022000011000011555500000000000000002200000000000000000000000022000000000000
0000000133223333333320000000000001332233333333200000000002333333333333333320000000023333333333333333200000000233335555333333331000000002333355553333333310000000000133335533333333100000000001333355333333331000000001333333555533331000000000013333335555333310000000013333333333333310000000000133333333333333100006660001333333333322331000067000013333333333223310000600000002333333333333331006660000023333333333333310000000000001335555333333331000000000013355553333333310000000013333335533333333100000000133333355333333331000000233333333555533333310000002333333335555333333100000000133333333333333200000000001333333333333332000000000000133332233332000000000000001333322333320000000
0055333333550000115500000000553333335500001155000000005533553355005500550055550055335533550055005500555500001155000011550000115500000011550000115500001155005555005555553333115500550055550055555533331155005500000000550000115500553333000000005500001155005533330000551100005500550000330000005511000055005500003306660055002255551155555500067000550022555511555555000600005500000000335500110006660055000000003355001100000055555500550000003355330000555555005500000033553300000000001155555533335555550000000011555555333355555500005555335500001155550000000055553355000011555500000000553333550000000000005500005533335500000000000055000055553333005555550055550000555533330055555500555500
4444444444442244444444000044444444444422444444440000444444111044444444441111104444441110444444444411111044444400104444444444440100444444001044444444444401004444111111114444441111110044441111111144444411111100444444000001000000000000004444440000010000000000000044444411001120011100200000444444110011200111002006660044444400220000000120067000444444002200000001200600444444110011200111002006664444441100112001110020000044444400000100000000000000444444000001000000000000004444111111114444441111110044441111111144444411111100444444001044444444444401004444440010444444444444010044444411104444444444111110444444111044444444441111104444444444442244444444000044444444444422444444440000
0000000000000000003300002200000000000000000033000000002200002220000233330000000022000000200002333300000000002200002233223333220002000022000000330033332200020000002200333333332200000000000022003333333322000000220000002200330022000000002200000022003300220000000000220033332233220000000000002200333322332200000006660000003333333333220000067000000033333333332200000600000022332233000000000006660000223322330000000000000000223333332200000200000000002233333322000002220000002233023300002200000000020022330233000022000000000200003322000000002200000022000033000000000022000000000000000000220000002200000000000000222222000022002200000000000000000000000022000000000000000000000000220000
0011110000000000000000000000000011000000000000000000001111001111110000000000000000001100000011111100000000111100000000001000111111000000000011000010000000000000111111000000100000000000111111110000001000001111110011110000001100001111000000110011001100001111000000110000111111111111000000110000000011111111001106660000000000111111111111067000000000000011111111000600000000001111111111001106660000001100110000111111000000111111110000000011111100000000001111000000001111000011111111001111111100111100001111111100000000000011000011111111111111110000110000001111111111000000001100000000000000001000001100000000000000000010111100000000000000000000110000000000000000000000001111000000
0000331111555511113300000000003311115555111133000000000000331155111111553300000000003311551111115533000000000033115511115555330000000000331155111155553300000000331111111155553300000000003311111111555533000000001111112211111155330000000011111122111111553300000000003311111111111133000000000033111111111111330006660011111122111111553300067000111111221111115533000600000033111111115555330006660000331111111155553300000000000033115511115555330000000000331155111155553300000000003311551111115533000000000033115511111155330000000033111155551111330000000000331111555511113300000000000033333355335555330000000000333333553355553300000000000000003333553300000000000000000033335533000000
